 abcdefghijklmnopqrstuvwxyz123
awwwwwwwwwwwwwwwwwwwwwwwwwwwww
bwA H H H H H H H H H H H H Bw
cw w w w w w w w w w w w w w w
dwH H H H H H H H H H H H H Hw
ew w w w w w w w w w w w w w w
fwH H H H H H H H H H H H H Hw
gw w w w w w w w w w w w w w w
hwH H H H H H H H H H H H H Hw
iw w w w w w w w w w w w w w w
jwH H H H H H H H H H H H H Hw
kw w w w w w w w w w w w w w w
lwH H H H H H H*H H H H H H HW
mw.w.w.w.w.www=w=www.w.w.w.w.w
nw.w.w.w.w.w       w.w.w.w.w.w
ow.w.w.w.w.w12d c34w.w.w.w.w.w
pw.w.w.w.w.wwwwwwwww.w.w.w.w.w   
 wH H H H H H H H H H H H H Hw            
qw w w w w w w w w w w w w w w
rwH H H H H H H H H H H H H Hw
sw w w w w w w w w w w w w w w
twH H H H H H H H H H H H H Hw
uw w w w w w w w w w w w w w w
vwH H H H H H H H H H H H H Hw
ww w w w w w w w w w w w w w w
xwH H H H H H H H H H H H H Hw
yw w w w w w w w w w w w w w w
zwH H H H H H H H H H H H H Hw
1w w w w w w w w w w w w w w w
2wH H H H H H H H H H H H H Hw
3w w w w w w w w w w w w w w w
4wC H H H H H H H H H H H H Dw
5wwwwwwwwwwwwwwwwwwwwwwwwwwwww

